25 13
3 1
27 28
%%%%%%%%%%%%%%%%%%%%%%%%%%%%
%------------%%------------%
%-%%%%-%%%%%-%%-%%%%%-%%%%-%
%.%%%%-%%%%%-%%-%%%%%-%%%%-%
%-%%%%-%%%%%-%%-%%%%%-%%%%-%
%--------------------------%
%-%%%%-%%-%%%%%%%%-%%-%%%%-%
%-%%%%-%%-%%%%%%%%-%%-%%%%-%
%------%%----%%----%%------%
%%%%%%-%%%%%-%%-%%%%%-%%%%%%
%%%%%%-%%%%%-%%-%%%%%-%%%%%%
%%%%%%-%------------%-%%%%%%
%%%%%%-%-%%%%--%%%%-%-%%%%%%
%--------%--------%--------%
%%%%%%-%-%%%%%%%%%%-%-%%%%%%
%%%%%%-%------------%-%%%%%%
%%%%%%-%-%%%%%%%%%%-%-%%%%%%
%------------%%------------%
%-%%%%-%%%%%-%%-%%%%%-%%%%-%
%-%%%%-%%%%%-%%-%%%%%-%%%%-%
%---%%----------------%%---%
%%%-%%-%%-%%%%%%%%-%%-%%-%%%
%%%-%%-%%-%%%%%%%%-%%-%%-%%%
%------%%----%%----%%------%
%-%%%%%%%%%%-%%-%%%%%%%%%%-%
%------------P-------------%
%%%%%%%%%%%%%%%%%%%%%%%%%%%%
33
3 9
3 10
3 11
3 12
3 13
3 14
3 15
3 16
2 16
1 16
1 17
1 18
2 18
3 18
4 18
5 18
5 17
5 16
5 15
5 14
5 13
5 12
5 11
5 10
5 9
5 8
5 7
5 6
5 5
5 4
5 3
5 2
5 1
32
3 9
3 10
3 11
3 12
3 13
3 14
3 15
3 16
2 16
1 16
1 17
1 18
2 18
3 18
4 18
5 18
5 17
5 16
5 15
5 14
5 13
5 12
5 11
5 10
5 9
5 8
5 7
5 6
5 5
5 4
5 3
5 2
5 1
